################
#....C...C.....#
#..O.....C..O..#
#....P..C......#
#..O.....C..O..#
#....C...C.....#
#......H.......#
################